00P00P000^v00P000P00
000OOO000^v000OOO000
B00000000^v00000000B
000000000^v000000000
000OOO000^v000OOO000
B00000000^v00000000B
000OOO000^v000OOO000
000000000^v000000000
00000000s^vS00000000
<<<<<<<<<++<<<<<<<<<
>>>>>>>>>++>>>>>>>>>
00000000S^vs00000000
000000000^v000000000
000OOO000^v000OOO000
B00000000^v00000000B
000OOO000^v000OOO000
B00000000^v00000000B
000OOO000^v000OOO000
000000000^v000000000
00P000P00^v000P000P0